#############################
#                           #
#                           #
#                           #
#                           #
#                           #
#                           #
#                           #
                             
                             
                             
#                           #
#                           #
#                           #
#         1234              #
#                           #
#                           #
#                           #
#                           #
#############################
