###########
#         #
#   #     #

    #
    #
    #
    #
    #
    #

#         #
#  1234   #
#         #
#         #
###########